#################
#.....#.E..E.E..#
#......E........#
#.....#E.#..E.###
#H....######..E.#
#.HH.....#.....E#
#HHH............#
#HH.H....#......#
#################