#######
##....#
#H..E.#
#.....#
#H..E.#
##....#
#######