###############
#.......#.EEE.#
#..H....#..E..#
#H..#...#..EE.#
#HH.##......E.#
#H..#...#.....#
#.......###.###
#.HH..........#
#..H..........#
###############