##############
#............#
#.H...#....E.#
#.H...##.....#
#.H....#...E.#
#............#
##############