###########
#.........#
#H.H.#.E.E#
#.H.....E.#
#H.H.#.E.E#
#.........#
###########