#################
#.E#..#.H.#..#E.#
#..#..#HHH#..#..#
#.....##.##.....#
#..#..H...H..#..#
#..#####.#####..#
#..E.........E..#
#.......E.......#
#################