########
#......#
#.H..E.#
#.H..E.#
#.H..E.#
#......#
########