#########################
#..#...............#....#
#..###.............#....#
#..................##...#
##..........####........#
###.........#...........#
#########################