##########
#...#....#
#.H....E.#
#........#
#.H....E.#
#....#...#
##########