#################
#.....#......E..#
#......E........#
#.....#..#..E.###
#.....######..E.#
#.H......#......#
#H.H............#
#.H......#......#
#################