###########
#.........#
#HHH.#.EEE#
#.H.....E.#
#HHH.#.EEE#
#.........#
###########