###############
#.......#.EEE.#
#.......#..E..#
#H..#...#.....#
#.H.##........#
#H..#...#.....#
#.......###.###
#..H..........#
#.............#
###############